111111111555555555555555555555
100000901500000050005000000005
100000001500000050005000000005
100000001500000050005000000005
111111011500000000000000000905
000030003500000050005000000005
000030003500000050095000000005
000030003500000050005000000005
333333033333333333033333333333
300000003000000000003000000003
300090003000000000003000090003
300000000000000000000000000003
300000003000000000003000000003
333333333333333333333333330333
200000000000020000000000000002
200009000000000000000000000002
200000000000020000000000000002
222222222222220222222222222222
444444444444440666666666666666
400000000000040600000000000006
400000009000000000000000000006
400000000000040600000009000006
400000000000040600000000000006
444444444444444446666606666666
600000000060000000006000000006
600000009060000000006000000006
600000000000000000000000000006
600000000060000000006000000006
600000000060000000006000000906
666666666666666666666666666666